01  16  16  16  16  16  16  16  16  16  16  16  16  16  16  16  16  16  16  16  16  16  16  16  16  16  16  16  16  16  16  16  16  16  16  16  16  16  16  16  16  16  16  16  16  16  16  16  16  16  16  16  16  16  16  16  16  16  16  16  16  16  16  16
01  16  16  16  16  16  16  16  16  16  16  16  16  16  16  16  16  16  16  16  16  16  16  16  16  16  16  16  16  16  16  16  16  16  16  16  16  16  16  16  16  16  16  16  16  16  16  16  16  16  16  16  16  16  16  16  16  16  16  16  16  16  16  16
01  16  16  16  16  16  16  16  16  16  16  16  16  16  16  16  16  16  16  16  16  16  16  16  16  16  16  16  16  16  16  16  16  16  16  16  16  16  16  16  16  16  16  16  16  16  16  16  16  16  16  16  01  01  01  01  01  01  16  16  16  16  16  16
01  16  16  16  16  16  16  16  16  16  16  16  16  16  16  16  16  16  16  16  16  16  16  16  16  16  16  16  16  16  16  16  16  16  16  16  16  16  16  16  16  16  16  16  16  16  16  16  16  16  16  16  16  16  16  16  16  16  16  16  16  16  16  16
01  16  16  16  16  16  16  16  16  16  16  16  16  16  16  16  16  16  16  16  16  16  16  16  16  16  16  16  16  16  16  16  16  16  16  16  16  16  16  16  16  16  16  16  16  16  16  16  16  16  16  16  16  16  16  16  16  16  16  16  16  16  16  16
01  16  16  16  16  16  16  16  16  16  16  16  16  16  16  16  01  01  03  16  16  16  16  16  16  16  16  16  16  16  16  16  16  16  16  16  16  16  16  16  16  16  16  16  16  16  16  16  16  16  16  16  16  16  16  16  16  16  16  16  16  16  16  16
01  16  16  16  16  16  16  16  16  16  16  16  16  16  16  16  16  16  16  16  16  16  16  16  16  16  16  16  16  16  16  16  16  16  16  16  16  16  16  01  01  01  16  16  16  16  16  16  16  16  16  16  16  16  16  16  16  16  16  16  16  16  16  16
01  16  16  16  01  16  16  16  16  16  16  16  16  16  16  16  16  16  16  16  16  16  16  16  01  16  16  16  16  16  16  16  01  16  16  16  16  16  16  16  16  16  16  16  16  16  16  16  16  16  16  16  16  16  16  16  16  16  16  16  16  16  16  16
01  16  16  16  01  01  16  16  16  16  16  16  16  16  16  16  16  16  16  16  16  16  16  16  01  16  16  16  16  16  16  16  01  16  16  16  16  16  16  16  16  16  16  16  16  16  16  16  16  16  16  16  16  16  16  16  16  01  16  16  16  16  16  16
01  16  16  16  01  01  01  16  16  16  16  16  16  16  01  01  16  13  16  16  16  16  16  16  01  16  16  16  16  16  16  16  01  16  16  16  16  16  16  16  16  16  16  16  16  16  16  16  16  16  16  16  16  16  16  16  01  01  16  16  16  16  16  16
01  01  01  01  01  01  01  01  01  01  01  01  01  01  01  01  01  01  01  01  01  01  01  01  01  01  01  01  01  01  01  01  01  01  01  01  01  01  01  01  01  01  01  01  01  01  01  01  01  01  01  01  01  01  01  01  01  01  01  01  01  01  01  01
